.........
....WD.H.
....W....
.C..W....
....W....
.........