.D......W
..W.W....
W.....W..
...W.WW..
...WHWWD.
.W.W.W...
DW.......
...WW....