.D......W
..W.W....
W.....W..
...WHWW..
...W.WWD.
.WHW.W...
DW.......
...WW....