.........
....WD.H.
....W....
.C..W.WW.
....W....
.........