.W......D.
..WWW.WW..
.C.....WW.
..WDW.....
.WW...WW..
.......C.W
.W..W.W...
WW...W.WC.
HD..WW....