........W..W
.W..W....C..
WD...W......
....CW..WW..
..WWWW.WWD.W
.....W..WW..
W..WW.HH.W..
....W...W...
WW.W..W..W.W
.....W.W...C
....WDW.....
C.W......WWW