.D......W
..W.W....
W.....W..
...W.WW..
...WHW.D.
.W.W.WWW.
DW.......
...WW....