.CW.W..DW.WC.
.W...........
DWW.W.WCH...W
......DW..DW.
..W.W....W...
.W.WW...WWW.W
..WH.....H...
W....WW.W..WW