.WCW.W..CW...
..W...W....W.
........W....
.DW.HW.W...WD
.....WDWH.WW.
W...WW.WW....
......C......
...W..W.W.W..
.WD...W.D....