...D....
.WH.W..C
.W..WW..
......W.
..WW..D.
W.....W.
W..DW..W
.C.WW..D
....W.W.
..W...H.
.W...W..