W..C..W....CWW.
....W..........
.W..W...DW....W
.D..W..WWW.W.D.
.WW............
...W..WWH.W.WW.
......WHW......
.W..W.HWW....W.
....W.....W.W..
.W.WWWW.W......
..D........W.WW
.W...W..WWD...W
.C...W.C.WW...W