.D..W...
....WWW.
WW..W.W.
H....W..
.W...W.C
...W.D..