...WW....
DW.......
.W.W.WWW.
...WHW.D.
...W.WW..
W.....W..
..W.W....
.D......W