.......W..WW.....WW
W..WD..W...D.......
W..WW....WWW.WW.WW.
......WW.WCW.......
.W.WC.........W.W..
.W.WW.W.W.W.W...WDW
D...W...W.W........
......WWH.HWW.WW...
..WW...........CW..
.W.DW.WWH.HWW..WW..
....W.W.W.WD..W...W
WW..W...W.W.W......
......W......W.WW.W
W.W....W.WC..W.W..W
....W.W...WW.......
.WWD....W..DWWW..D.
CW..WW...........WW