W.WD..W.....DW
..W......W....
.......D..W.W.
.WC.W.WW......
H.W.W.W..W.WW.
......WC.W.HW.
WW.W..H..W.WWC
D..W..W.......
....W.W..W..W.
..W......W....
W.WCW.DW...WD.
..W..WWWW...WW
D..W..HW..W.D.
WW...........W